name=Map0
map=###
B000B000B000B000B000B000B000B000B000B000B000B000B000B000B000B000B000B000B000B000B000B000B000B000B000B000B000B000B000B000B000B000B000B000B000B000B000B000B000B000B004B000B000B000B000B000B000B002B000B000B000B000B004B000B001B000B000B000B000B000B000B000B000B000B000B000B004B000B000B000B000B000B000B002B000B004B000B000B004B000B001B000B000B002B000B000B000B000B000B000B000B000B004B000B000B000B000B000B000B002B000B004B000B000B004B000B001B000B000B002B000B000B000B000B000B000B000B000B004B000B000B000B000B000B000B002B000B004B000B000
B000B000B000B000B000B000B000B000B000B000B004B000E001B000B000B000B000B000B000B000B000B000B000B000B000B000B000B000B000B000B000B000B000B000B000B000B000B000B000B000B000B000B000B001B000B000B000B000B000B000B000B000B000B000B000B000B000B000B000B000B000B000B004B000B000B000B000B000B000B001B000B000B000B000B000B000B000B000B000B000B000B000B000B000B000B000B000B000B004B000B000B000B000B000B000B001B000B000B000B000B000B000B000B000B000B000B000B000B000B000B000B000B000B000B004B000B000B000B000B000B000B001B000B000B000B000B000B000B000B000
B000B000B000B000B000B000B000B000B000B000B000B000B000B000B000B000B000B000B000B000B000B000B000B000B001B000B000B000B000B000B000B000B000B000B000B000B000B000B000B000B000B000B000B000B000B000B000B000B000B000B000B000B000B000B000B000B000B003B000B000B000B000B000B000B002B000B001B000B000B000B000B000B000B003B000B000B001B000B000B000B000B000B000B003B000B000B000B000B000B000B002B000B001B000B000B000B000B000B000B003B000B000B001B000B000B000B000B000B000B003B000B000B000B000B000B000B002B000B001B000B000B000B000B000B000B003B000B000B001B000
B000B000B000B002B000B000B000B000B000B000B000B000E002B000B000B000B000B000B000B000B000B000B000B000B000B000B000B000B000B002B000B000B000B000B001B000B000B000B000B000B000B000B000B000B000B000B000B000B000B000B000B000B000B000B000B000B000B000B000B000B000B000B000B000B000B000B000B003B000B000B000B000B001B000B000B000B000B000B000B000B000B002B000B000B000B000B001B000B000B000B000B000B000B003B000B000B000B000B001B000B000B000B000B000B000B000B000B002B000B000B000B000B001B000B000B000B000B000B000B003B000B000B000B000B001B000B000B000B000B000
B000B000B000B000B000B000B000B000B000B000B000B000B000B000B000B000B000B000B000B000B000B000B000B000B000B000B000B000B000B000B000B000B000B000B000B000B000B000B000B000B000B000B000B000B000B000B000B000B000B000B000B000B000B000B000B000B000B000B000B000B000B000B000B003B000B000B000B000B000B004B000B000B000B000B000B000B000B004B000B004B000B000B000B000B000B000B000B000B000B003B000B000B000B000B000B004B000B000B000B000B000B000B000B004B000B004B000B000B000B000B000B000B000B000B000B003B000B000B000B000B000B004B000B000B000B000B000B000B000B004
B000B000B000B000B000B000B000B000B000B000B000B000E003B000B000B000B000B000B000B000B000B001B000B000B000B000B000B000B000B000B000B000B000B000B000B000B000B000B001B000B000B000B000B000B000B000B000B001B000B000B000B000B000B000B000B000B000B000B000B004B000B000B000B000B001B000B000B000B003B000B000B000B000B001B000B000B000B000B000B000B000B000B000B000B000B004B000B000B000B000B001B000B000B000B003B000B000B000B000B001B000B000B000B000B000B000B000B000B000B000B000B004B000B000B000B000B001B000B000B000B003B000B000B000B000B001B000B000B000B000
B000B000B000B000B000B000B000B000B000B000B000B000B000B000B000B000B000B000B000B000B000B000B000B000B000B000B000B000B000B000B000B000B000B000B000B000B000B000B000B000B000B000B000B000B000B000B000B000B000B000B000B000B000B000B000B000B000B000B000B000B000B000B000B000B002B000B000B000B000B000B002B000B000B000B000B000B002B000B000B000B000B000B000B000B001B000B000B000B000B000B002B000B000B000B000B000B002B000B000B000B000B000B002B000B000B000B000B000B000B000B001B000B000B000B000B000B002B000B000B000B000B000B002B000B000B000B000B000B002B000
B000B000B000B000B000B000B000B000B000B000B000B000E004B000B000B000B000B001B000B000B000B000B000B000B000B000B000B000B000B000B000B000B000B000B000B000B000B000B000B000B000B000B000B000B000B000B000B000B000B000B003B000B000B000B000B000B000B000B000B000B000B004B000B000B000B000B000B000B000B001B000B000B002B000B000B000B003B000B002B000B000B000B004B000B000B000B000B004B000B000B000B000B000B000B000B001B000B000B002B000B000B000B003B000B002B000B000B000B004B000B000B000B000B004B000B000B000B000B000B000B000B001B000B000B002B000B000B000B003B000
B000B000B000B000B000B000B000B000B000B000B000B000B000B000B000B000B000B000B000B000B004B000B000B000B000B000B000B000B000B000B000B000B000B000B003B000B000B000B000B000B000B000B000B000B000B000B004B000B000B000B000B000B000B000B000B004B000B000B000B000B003B000B000B000B000B000B001B000B000B000B000B000B004B000B000B000B000B001B000B000B000B004B000B000B000B000B003B000B000B000B000B000B001B000B000B000B000B000B004B000B000B000B000B001B000B000B000B004B000B000B000B000B003B000B000B000B000B000B001B000B000B000B000B000B004B000B000B000B000B001
B000B000B003B000B000B000B000B000B000B000B000B000E005B000B000B000B000B000B000B000B000B000B000B000B000B000B000B000B003B000B000B000B000B000B000B000B000B000B000B000B000B000B000B000B000B000B000B000B000B000B000B000B000B000B000B000B000B000B000B000B000B000B003B000B000B000B001B000B000B000B000B000B000B000B004B000B000B000B000B000B003B000B000B000B000B000B000B000B003B000B000B000B001B000B000B000B000B000B000B000B004B000B000B000B000B000B003B000B000B000B000B000B000B000B003B000B000B000B001B000B000B000B000B000B000B000B004B000B000B000
B000B000B000B000B000B000B000B000B000B000B000B000B000B000B000B000B000B000B000B000B000B000B000B000B000B004B000B000B000B000B000B000B000B000B000B000B000B000B000B000B000B000B000B000B000B000B000B000B000B000B000B000B000B004B000B000B000B000B000B000B000B000B001B000B000B000B000B000B000B000B004B000B000B000B000B001B000B004B000B004B000B000B000B000B000B000B000B000B001B000B000B000B000B000B000B000B004B000B000B000B000B001B000B004B000B004B000B000B000B000B000B000B000B000B001B000B000B000B000B000B000B000B004B000B000B000B000B001B000B004
B000B000B000B000B000B000B000B000B000B000B000B000B000B000B000B000B000B000B000B000B000B000B000B000B000B000B000B000B000B000B000B000B000B000B000B000B000B000B000B000B000B002B000B000B000B000B000B000B000B000B000B000B000B000B000B000B000B002B000B000B000B000B000B000B000B000B000B002B000B000B000B000B001B000B000B000B000B000B000B000B000B000B000B002B000B000B000B000B000B000B000B000B000B002B000B000B000B000B001B000B000B000B000B000B000B000B000B000B000B002B000B000B000B000B000B000B000B000B000B002B000B000B000B000B001B000B000B000B000B000
###