name=Autralopitoucan
map=###
0001000100010001000100010001000100010001000100010001000100010001000100010001
0001000000000000000000000000000000000000000000000000000000000000000000000001
0001000100010001000100000000000100010001000100010001000100000000000100010001
0001000000000000000000000000000000000000000000000000000000000000000000000001
0001000000000000000000000000000000000000000000000000000000000000000000000001
0001000000000000000000000000000000000000000000000000000000000000000000000001
0001000000000000000000000000000000000000000000000000000000000000000000000001
0001000000000000000000000000000000000000000000000000000000000000000000000001
0001000000000000000000000000000000000000000000000000000000000000000000000001
0001000000000000000000000000000000000000000000000000000000000000000000000001
0001000000000000000000000000000000000000000000000000000000000000000000000001
0001000000000000000000000000000000000000000000000000000000000000000000000001
0001000000000000000000000000000000000000000000000000000000000000000000000001
0001000100010001000100000000000100010001000100010001000100000000000100010001
0001000100010001000100010001000100010001000100010001000100010001000100010001
###